14
20
XXXXXXXXXXXXXXXXXXXX
X....X..XSX...X...VX
X.XXIX..X...X...XT.X
X.XXXXTTXXXDXXXXXXXX
X....X.............X
X....X...X.........X
X.......X.X........X
X..X...XX.XX....X..X
X..X...X........X.TX
X..X.X.X...C....XXXX
X..................X
XXXTXXX....X...X...X
XSP................X
XXXXXXXXXXXXXXXXXXXX
