14
20
XXXXXXXXXXXXXXXXXXXX
XXS......X........XX
X....M...X.....B...X
X........X...X.....X
X..X.....X........XX
XXXXXXXXDX....I....X
X...X....X....M....X
X..X..........X....X
X.....X............X
XX.................X
X...E........T.....X
X...........F......X
XX..S............PXX
XXXXXXXXXXXXXXXXXXXX
