14
20
XXXXXXXXXXXXXXXXXXXX
X...A...XSX........X
X.......X.X........X
X.......X.X.....M..X
X...M...X.X........X
X.......X.X........X
X.......XTX........X
X.......X.X........X
X......AX.X........X
X.......X.X...A....X
X..M....X.X........X
X.......X.X........X
X.......XSX........X
XXXXXXXXXXXXXXXXXXXX
