14
20
XXXXXXXXXXXXXXXXXXXX
XV....A........D..SX
XXX.XXX........XTTTX
X..........M...XTTTX
X..X...........XTTTX
X...........X..XTTTX
X..................X
X..X...X...........X
X..............X...X
X....Z.............X
X......X........VPSX
XXXXXX.............X
XTI................X
XXXXXXXXXXXXXXXXXXXX
