14
20
XXXXXXXXXXXXXXXXXXXX
X...O...XSX........X
X.......X.X........X
X.......X.X.....M..X
X...M...X.X........X
X.......X.X........X
X.......XTX........X
X.......X.X........X
X......OX.X........X
X.......X.X...O....X
X..M....X.X........X
X.......X.X........X
X.......XSX........X
XXXXXXXXXXXXXXXXXXXX
