14
20
XXXXXXXXXXXXXXXXXXXX
X.............X...SX
X.......X.IT..X....X
X.......XXXXXXXXXDXX
X.........M........X
X..................X
X.X................X
X.X................X
X.X........M.......X
X.X................X
X.T.T.T.T.T........X
X.X................X
XSX...V.V..........X
XXXXXXXXXXXXXXXXXXXX
