14
20
XXXXXXXXXXXXXXXXXXXX
X.........S........X
X..................X
X..................X
X..................X
X..................X
X..................X
X..................X
X..................X
X..................X
X..................X
X..................X
X.........P........X
XXXXXXXXXXXXXXXXXXXX
