14
20
XXXXXXXXXXXXXXXXXXXX
XXS......X........XX
X........X.....B...X
X........X...X.....X
X..X.....X........XX
XXXXXXXXDX....I....X
X...X....X.........X
X..X..........X....X
X.....X............X
XX.................X
X...E........T.....X
X..................X
XX...............PXX
XXXXXXXXXXXXXXXXXXXX
