14
20
XXXXXXXXXXXXXXXXXXXX
X.........S........X
X..................X
X..................X
XXXXXXXXXXDXXXXXXXXX
X..................X
X..................X
X..................X
X..................X
X...........I......X
X..................X
X..................X
XSP................X
XXXXXXXXXXXXXXXXXXXX
