14
20
XXXXXXXXXXXXXXXXXXXX
X..................X
X..X.......XX..XXXXX
X.XX...A...........X
X..X.......F.......X
X..X.T..XXXX..XXX..X
XS.X....XP......X..X
XTXX...EX..T....X..X
XXXXXXXXXXXXXXXXXXDX
X......X.......VX..X
XI..X.....XTXXXXX..X
X..XXX...XX....XX..X
X..T.......M......SX
XXXXXXXXXXXXXXXXXXXX
