14
20
XXXXXXXXXXXXXXXXXXXX
X..................X
X..X.......XX..XXXXX
X.XX...............X
X..X...............X
X..X.T..XXXX..XXX..X
XS.X....XP......X..X
XTXX...EX..T....X..X
XXXXXXXXXXXXXXXXXXDX
X......X.......VX..X
XI..X.....XTXXXXX..X
X..XXX...XX....XX..X
X..T..............SX
XXXXXXXXXXXXXXXXXXXX
