14
20
XXXXXXXXXXXXXXXXXXXX
X.........S........X
X..................X
X..................X
X..........M.......X
X..................X
X..................X
X..................X
X..................X
X..................X
X..................X
X..................X
XSP................X
XXXXXXXXXXXXXXXXXXXX
