14
20
XXXXXXXXXXXXXXXXXXXX
X..................X
X..X............X..X
X..X..M.........XV.X
X..X............XX.X
X.XX....XXXX.XXXXF.X
XITX....XS.X....X.EX
X.XX..F.X..D....X.TX
X..X....XXXX.XXXX..X
XM.X............X..X
XX.X............XX.X
X..X............XM.X
X.......SP.........X
XXXXXXXXXXXXXXXXXXXX
