14
20
XXXXXXXXXXXXXXXXXXXX
X.........S........X
X..................X
X..................X
X.........M........X
X...A..............X
X..M.F.............X
X..................X
X..................X
X..................X
X...E.....B....V...X
X..................X
XS.................X
XXXXXXXXXXXXXXXXXXXX
