14
20
XXXXXXXXXXXXXXXXXXXX
XSX....T.....T....TX
X.X..XXXXXXXXXXX...X
X..T..F........X.T.X
X.........T....X...X
X..A...........XT..X
XXXXXX........XI.XXX
XF...D........X.X..X
X..M.X.....F.......X
XM...X.............X
X.C.FX..F..........X
XXXXXX.............X
XP.....M.........S.X
XXXXXXXXXXXXXXXXXXXX
